#############G#
#           # #
###  ##  # #  #
#    ## ##   ##
# ### ## #### #
#     #       #
##  ###  ######
###      # #  #
## #####      #
#      ###  # #
#### #     # ##
#    ######   #
# ##  # # ##  #
M #           #
###############
